####################
#   F F   S       S#
#          F       #
#     #########    #
#   ###########    #
#    ########      #
#F   #     S       #
#    #  F     S    #
#      S           #
############### ####
