##############################
# S                          #
# #        #           S     #
# #        #                 #
# #        #       S         #
# #S       #                 #
# #        #                 #
# ######    F   F            #
  #    ########     F        #
# #            S             #
#        F                   #
#      #         F           #
#                            #
#                            #
##############################
