###############
#     F   S  F#
#S    ######  #
#  ####  #    #
#  F   S #  S #
#    F   # #  #
#    ###F# #  # 
#   S    # S F#
#     F  F    #
#### ##########